NO ./texture/wall_n.xpm
SO ./texture/wall_s.xpm
WE ./texture/wall_w.xpm
EA ./texture/wall_e.xpm

F 220,100,0
C 225,30,0

11111
11001
10N01
10001
11111
