NO ./texture/wall_n.xpm
SO ./texture/wall_s.xpm
WE ./texture/wall_w.xpm
EA ./texture/wall_e.xpm

F 220,100,0
C 225,30,0

111111111111 111111111111
  111011100111101111110111
1110000000110000000001111
1011000001110000000000001
100100000000000000000000111111111
111111111111000001110000000000001
100001    11000001110111111111111
111101    1111011100000010001
11110111111111011101010010001
11000000110101011100000010001
10000000000000001100000010001
10000000000000001101010010001
11000001110101011111011110N0111
11110111 1110101 101111010001
11111111 1111111 111111111111
